5 7 16
0 0 0 1 0 0 0
0 1 1 3 1 1 0
1 2 3 3 3 2 1
0 1 1 3 1 1 0
0 0 0 1 0 0 0
0 0 0 0 0 0 0
0 0 0 0 0 0 6
0 0 0 0 0 0 0
0 0 0 0 0 0 0
0 0 0 0 0 0 0